########
#P     #
# #### #
#  S## #
# #    #
# ## # #
#    #P#
########
