############
#P         #
#          #
#  #####   #
#    S##   #
#          #
#  #       #
#  ###  #  #
#       #  #
#       # P#
############
